####################
#                  #
# ###  ######  ### #
# #              # #
# #  ##    ##   #  #
#    #        #    #
# #  #        #   ##
# #  ##    ##  #   #
# ###  ######  #  ##
#         #        #
####   #  #  #     #
#      #     #     #
#  #####  ####     #
#                  #
####  #########    #
#     #       #    #
#  ####  ###  ######
#        # #       #
######   # #   #   #
#                  #
####################
